00000000000000000000000000000000000000000000000000000000000000000
00000000000000000000000000000000000000000000000000000000000000000
00000000000000000000000000000000000000000000000000000000000000000
00000000000000000000000000003333333000000000000000000033330000000
00000000000000000000000000000000000000000000000000000000000000000
00000000000000000000000000000000000000000000000000000000000000000
00000005550000000000000333000000000000033330000000000000000033330
00000000000000000000000000000000000000000000000000000000000000000
00000000000000000000000000000000000000000000000000000440000000000
00000005550000000000000055000000000000000053000000000000000000330
00000000000000000000000000000000000000000000000000000000000000000
00000000000000000444000000000000000000000000000000000000000000009
00000005550000000000000053000000000000000053000000000000000000337
00000000000000000000000000000000000000000000000000000000000000007
00000000000000000000000000000000000000000440000000000000000000007
00000005550004400000000000000004400000000000000000555000000004407
00000000000000000000000033000000000000000033000000000000000003308
22222222222222222222222222222222222222222222222222222222222222222
11111111111111111111111111111111111111111111111111111111111111111
11111111111111111111111111111111111111111111111111111111111111111
11111111111111111111111111111111111111111111111111111111111111111
11111111111111111111111111111111111111111111111111111111111111111